Clamator coromandus	Chestnut-winged Cuckoo
Alauda arvensis/gulgula	Eurasian/Oriental Skylark
Ardenna carneipes	Flesh-footed Shearwater
Ichthyophaga ichthyaetus	Gray-headed Fish-Eagle
Otus lettia	Collared Scops-Owl
Aythya nyroca	Ferruginous Duck
Aegithalos iouschistos	Black-browed Tit
Anatidae sp.	waterfowl sp.
Cinclidium leucurum	White-tailed Robin
Xenus cinereus	Terek Sandpiper
Horornis flavolivaceus	Aberrant Bush-Warbler
Catreus wallichii	Cheer Pheasant
Accipiter butleri	Nicobar Sparrowhawk
Merops apiaster	European Bee-eater
Psittacula eupatria	Alexandrine Parakeet
Hydroprogne caspia	Caspian Tern
Elachura formosa	Spotted Elachura
Corvus macrorhynchos	Large-billed Crow
Dryocopus javensis	White-bellied Woodpecker
Aviceda leuphotes	Black Baza
Psilopogon malabaricus/haemacephalus	Malabar/Coppersmith Barbet
Anthus trivialis	Tree Pipit
Ardea alba	Great Egret
Acridotheres grandis	Great Myna
Rhyticeros undulatus	Wreathed Hornbill
Tarsiger chrysaeus	Golden Bush-Robin
Dendrocitta formosae	Gray Treepie
Carpodacus sp.	rosefinch sp.
Rynchops albicollis	Indian Skimmer
Locustella certhiola	Pallas's Grasshopper-Warbler
Dicrurus annectans	Crow-billed Drongo
Nisaetus cirrhatus	Crested Hawk-Eagle
Mycteria leucocephala	Painted Stork
Glareola sp.	pratincole sp.
Ichthyaetus ichthyaetus	Pallas's Gull
Zosterops palpebrosus	Oriental White-eye
Yuhina flavicollis	Whiskered Yuhina
Certhia himalayana	Bar-tailed Treecreeper
Lanius isabellinus	Isabelline Shrike
Dendrocitta leucogastra	White-bellied Treepie
Scolopacidae sp. (large shorebird sp.)	large shorebird sp.
Ploceus philippinus	Baya Weaver
Pyrrhula aurantiaca	Orange Bullfinch
Hydrobatidae sp.	storm-petrel sp.
Treron apicauda	Pin-tailed Pigeon
Vanellus cinereus	Gray-headed Lapwing
Zapornia pusilla	Baillon's Crake
Chloropsis cochinchinensis	Blue-winged Leafbird
Sitta himalayensis	White-tailed Nuthatch
Chroicocephalus genei	Slender-billed Gull
Emberiza sp.	Emberiza sp.
Calidris falcinellus	Broad-billed Sandpiper
Artamus fuscus	Ashy Woodswallow
Arborophila atrogularis	White-cheeked Partridge
Cyornis tickelliae	Tickell's Blue-Flycatcher
Ardenna tenuirostris	Short-tailed Shearwater
Platalea leucorodia	Eurasian Spoonbill
Hemicircus canente	Heart-spotted Woodpecker
Ardea alba/Mesophoyx intermedia	Great/Intermediate Egret
Francolinus gularis	Swamp Francolin
Spilornis klossi	Nicobar Serpent-Eagle
Monticola cinclorhynchus	Blue-capped Rock-Thrush
Centropus sp.	coucal sp.
Picus squamatus	Scaly-bellied Woodpecker
Pteruthius xanthochlorus	Green Shrike-Babbler
Hydrornis nipalensis	Blue-naped Pitta
Falco severus	Oriental Hobby
Calidris alba	Sanderling
Dicaeum agile	Thick-billed Flowerpecker
Clanga hastata	Indian Spotted Eagle
Onychoprion anaethetus	Bridled Tern
Calidris tenuirostris	Great Knot
Caprimulgus sp.	Caprimulgus sp.
Carduelis flavirostris	Twite
Picus chlorolophus	Lesser Yellownape
Eumyias thalassinus	Verditer Flycatcher
Dendrocopos nanus	Brown-capped Woodpecker
Hirundinidae sp.	swallow sp.
Psittiparus ruficeps	White-breasted Parrotbill
Anas sp. (teal sp.)	teal sp.
Thalasseus bengalensis	Lesser Crested Tern
Pelecanus crispus	Dalmatian Pelican
Aythya ferina	Common Pochard
Ducula sp.	imperial-pigeon sp.
Acridotheres ginginianus	Bank Myna
Circus aeruginosus	Eurasian Marsh-Harrier
Cacomantis merulinus/passerinus	Plaintive/Gray-bellied Cuckoo
Pomatorhinus superciliaris	Slender-billed Scimitar-Babbler
Pyrrhula nipalensis	Brown Bullfinch
Lerwa lerwa	Snow Partridge
Oenanthe oenanthe	Northern Wheatear
Iduna/Hippolais/Acrocephalus sp.	Iduna/Hippolais/Acrocephalus sp.
Dendrocopos auriceps	Brown-fronted Woodpecker
Pelecanus sp.	pelican sp.
Merops leschenaulti	Chestnut-headed Bee-eater
Phylloscopus occipitalis	Western Crowned Leaf Warbler
Tringa sp.	Tringa sp.
Alcippe ludlowi	Ludlow's Fulvetta
Oriolus traillii	Maroon Oriole
Phaenicophaeus viridirostris	Blue-faced Malkoha
Prinia atrogularis	Black-throated Prinia
Zoonavena sylvatica	White-rumped Needletail
Ficedula parva	Red-breasted Flycatcher
Ceryle rudis	Pied Kingfisher
Gallinago megala	Swinhoe's Snipe
Sitta cashmirensis	Kashmir Nuthatch
Chrysococcyx maculatus	Asian Emerald Cuckoo
Sula dactylatra	Masked Booby
Streptopelia orientalis	Oriental Turtle-Dove
Turdoides striata/affinis	Jungle/Yellow-billed Babbler
Napothera epilepidota	Eyebrowed Wren-Babbler
Stercorarius sp. (skua sp.)	skua sp.
Lonchura malacca	Tricolored Munia
Calandrella dukhunensis	Syke's Short-toed Lark
Ocyceros griseus	Malabar Gray Hornbill
Phylloscopus griseolus	Sulphur-bellied Warbler
Picumnus innominatus	Speckled Piculet
Niltava macgrigoriae	Small Niltava
Falco naumanni/tinnunculus	Lesser/Eurasian Kestrel
Spelaeornis longicaudatus	Tawny-breasted Wren-Babbler
Columba palumbus	Common Wood-Pigeon
Ianthocincla cineracea	Moustached Laughingthrush
Zoothera mollissima/salimalii	Alpine/Himalayan Thrush
Lonchura kelaarti	Black-throated Munia
Falco jugger	Laggar Falcon
Aquila rapax	Tawny Eagle
Megapodius nicobariensis	Nicobar Scrubfowl
Merops sp.	bee-eater sp.
Polyplectron germaini	Germain's Peacock-Pheasant
Stercorarius antarcticus	Brown Skua
Ichthyaetus hemprichii	Sooty Gull
Dicrurus andamanensis	Andaman Drongo
Podiceps nigricollis	Eared Grebe
Phoenicopterus roseus	Greater Flamingo
Circaetus gallicus	Short-toed Snake-Eagle
Cacomantis sonneratii	Banded Bay Cuckoo
Anser fabalis	Taiga Bean-Goose
Picus flavinucha	Greater Yellownape
Enicurus schistaceus	Slaty-backed Forktail
Sternula albifrons/saundersi	Little/Saunders's Tern
Tragopan blythii	Blyth's Tragopan
Gracula indica	Southern Hill Myna
Pycnonotus leucogenys	Himalayan Bulbul
Dinopium sp.	flameback sp.
Perdicula asiatica/argoondah	Jungle/Rock Bush-Quail
Sylvia crassirostris	Eastern Orphean Warbler
Rallina canningi	Andaman Crake
Laridae sp.	gull/tern sp.
Delichon sp.	house-martin sp.
Nisaetus kelaarti	Legge's Hawk-Eagle
Meleagris gallopavo	Wild Turkey
Gyps indicus	Indian Vulture
Aegithina tiphia	Common Iora
Turdidae sp.	thrush sp.
Phylloscopus trochiloides	Greenish Warbler
Eurystomus orientalis	Dollarbird
Lanius vittatus	Bay-backed Shrike
Dicrurus bracteatus	Spangled Drongo
Mycerobas melanozanthos	Spot-winged Grosbeak
Montifringilla adamsi	Black-winged Snowfinch
Alaudidae sp.	lark sp.
Cochoa purpurea	Purple Cochoa
Centropus sinensis	Greater Coucal
Motacilla cinerea	Gray Wagtail
Ocyceros birostris	Indian Gray Hornbill
Columba palumboides	Andaman Wood-Pigeon
Galloperdix spadicea	Red Spurfowl
Pelargopsis capensis	Stork-billed Kingfisher
Yuhina sp.	yuhina sp.
Corvus corax	Common Raven
Columba eversmanni	Pale-backed Pigeon
Metopidius indicus	Bronze-winged Jacana
Tesia olivea	Slaty-bellied Tesia
Mirafra assamica	Bengal Bushlark
Ploceus sp.	Ploceus sp.
Circus cyaneus	Northern Harrier
Nucifraga caryocatactes	Eurasian Nutcracker
Pericrocotus flammeus	Orange Minivet
Emberiza leucocephalos	Pine Bunting
Corvus corone	Carrion Crow
Calliope pectoralis	White-tailed Rubythroat
Cairina moschata	Muscovy Duck
Vanellus indicus	Red-wattled Lapwing
Apodidae sp. (large swift sp.)	large swift sp.
Caprimulgus mahrattensis	Sykes's Nightjar
Glareola pratincola	Collared Pratincole
Dicaeum erythrorhynchos	Pale-billed Flowerpecker
Prinia sylvatica	Jungle Prinia
Centropus bengalensis	Lesser Coucal
Psilopogon franklinii	Golden-throated Barbet
Hydrobatidae sp. (white-rumped)	storm-petrel sp. (white-rumped)
Riparia riparia/diluta	Bank Swallow/Pale Sand Martin
Enicurus maculatus	Spotted Forktail
Oenanthe pleschanka	Pied Wheatear
Circus sp.	harrier sp.
Eremophila alpestris	Horned Lark
Larus fuscus	Lesser Black-backed Gull
Ianthocincla ruficollis	Rufous-necked Laughingthrush
Turdus albocinctus	White-collared Blackbird
Chlidonias niger	Black Tern
Lonchura sp.	Lonchura sp.
Falco tinnunculus	Eurasian Kestrel
Anastomus oscitans	Asian Openbill
Cholornis unicolor	Brown Parrotbill
Brachypteryx hyperythra	Rusty-bellied Shortwing
Trochalopteron subunicolor	Scaly Laughingthrush
Sterna dougallii	Roseate Tern
Spilornis elgini	Andaman Serpent-Eagle
Cacomantis merulinus	Plaintive Cuckoo
Alaudala raytal	Sand Lark
Antigone antigone	Sarus Crane
Turdus atrogularis	Black-throated Thrush
Accipiter gentilis	Northern Goshawk
Bubo nipalensis	Spot-bellied Eagle-Owl
Oriolus kundoo	Indian Golden Oriole
Pycnonotus jocosus	Red-whiskered Bulbul
Larvivora brunnea	Indian Blue Robin
Motacilla alba	White Wagtail
Cyanoderma ambiguum	Buff-chested Babbler
Hydroprogne/Thalasseus sp.	large tern sp.
Falco columbarius	Merlin
Anthipes monileger	White-gorgeted Flycatcher
Cecropis daurica/striolata	Red-rumped/Striated Swallow
Buteo/eagle sp.	Buteo/eagle sp.
Cettia major	Chestnut-crowned Bush-Warbler
Turdus rubrocanus	Chestnut Thrush
Oriolus oriolus	Eurasian Golden Oriole
Iduna caligata	Booted Warbler
Ardeola bacchus	Chinese Pond-Heron
Charadrius alexandrinus	Kentish Plover
Podiceps grisegena	Red-necked Grebe
Gallus gallus	Red Junglefowl
Turdus ruficollis	Red-throated Thrush
Ptyonoprogne rupestris	Eurasian Crag-Martin
Galerida cristata	Crested Lark
Pnoepyga pusilla	Pygmy Cupwing
Urocissa flavirostris/erythroryncha	Yellow-billed/Red-billed Blue-Magpie
Otus scops	European Scops-Owl
Treron affinis	Gray-fronted Green-Pigeon
Hirundo domicola	Hill Swallow
Cyornis nicobaricus	Nicobar Jungle-Flycatcher
Clangula hyemalis	Long-tailed Duck
Acrocephalus concinens	Blunt-winged Warbler
Timaliidae sp.	babbler sp.
Harpactes wardi	Ward's Trogon
Glaucidium radiatum	Jungle Owlet
Ducula badia	Mountain Imperial-Pigeon
Lanius schach	Long-tailed Shrike
Passer domesticus	House Sparrow
Egretta/Bubulcus sp.	white egret sp.
Phyllergates cucullatus	Mountain Tailorbird
Micropternus brachyurus	Rufous Woodpecker
Anas sp.	dabbling duck sp.
Oceanites oceanicus	Wilson's Storm-Petrel
Phoenicurus fuliginosus	Plumbeous Redstart
Actitis hypoleucos/macularius	Common/Spotted Sandpiper
Tragopan melanocephalus	Western Tragopan
Mergellus albellus	Smew
Dicrurus hottentottus	Hair-crested Drongo
Chloris ambigua	Black-headed Greenfinch
Fregata andrewsi	Christmas Island Frigatebird
Tephrodornis sylvicola	Malabar Woodshrike
Dicrurus leucophaeus	Ashy Drongo
Prinia inornata	Plain Prinia
Lonchura molucca	Black-faced Munia
Certhia discolor	Sikkim Treecreeper
Macropygia unchall	Barred Cuckoo-Dove
Pomatorhinus schisticeps	White-browed Scimitar-Babbler
Sitta castanea/cinnamoventris	Indian/Chestnut-bellied Nuthatch
Dendrocopos hyperythrus	Rufous-bellied Woodpecker
Euodice malabarica	Indian Silverbill
Saxicola maurus	Siberian Stonechat
Lyncornis macrotis	Great Eared-Nightjar
Mycerobas affinis	Collared Grosbeak
Orthotomus atrogularis	Dark-necked Tailorbird
Sterna sp.	Sterna sp.
Anthus sp.	pipit sp.
Phalaropus lobatus	Red-necked Phalarope
Bucephala clangula	Common Goldeneye
Pternistis/Francolinus/Peliperdix/Scleroptila sp.	francolin sp.
Pelecanus onocrotalus	Great White Pelican
Turdus merula	Eurasian Blackbird
Gallinago stenura/megala	Pin-tailed/Swinhoe's Snipe
Botaurus stellaris	Great Bittern
Saxicola leucurus	White-tailed Stonechat
Bulweria fallax	Jouanin's Petrel
Lophotriorchis kienerii	Rufous-bellied Eagle
Remiz coronatus	White-crowned Penduline-Tit
Otus bakkamoena	Indian Scops-Owl
Caprimulgus macrurus	Large-tailed Nightjar
Turdus maximus	Tibetan Blackbird
Phoenicurus erythronotus	Rufous-backed Redstart
Luscinia svecica	Bluethroat
Ficedula hyperythra	Snowy-browed Flycatcher
Spelaeornis badeigularis	Rusty-throated Wren-Babbler
Ploceus manyar	Streaked Weaver
Phylloscopus nitidus/trochiloides	Green/Greenish Warbler
Hirundo tahitica	Pacific Swallow
Pericrocotus ethologus	Long-tailed Minivet
Porzana porzana	Spotted Crake
Microhierax melanoleucos	Pied Falconet
Garrulax monileger	Lesser Necklaced Laughingthrush
Anthus richardi	Richard's Pipit
Psittacula sp.	Psittacula sp.
Garrulax/Ianthocincla/Trochalopteron sp.	laughingthrush sp.
Phylloscopus sindianus	Mountain Chiffchaff
Spinus spinus	Eurasian Siskin
Seicercus affinis	White-spectacled Warbler
Mixornis gularis	Pin-striped Tit-Babbler
Dendrocopos atratus	Stripe-breasted Woodpecker
Caprimulgus indicus/jotaka	Jungle/Gray Nightjar
Ianthocincla ocellata	Spotted Laughingthrush
Dendrocitta vagabunda	Rufous Treepie
Glaucidium cuculoides/radiatum	Asian Barred/Jungle Owlet
Psilopogon zeylanicus	Brown-headed Barbet
Ficedula sordida	Slaty-backed Flycatcher
Gallus sonneratii	Gray Junglefowl
Anser sp. (Domestic type)	Domestic goose sp. (Domestic type)
Acrocephalus agricola	Paddyfield Warbler
Calidris minuta	Little Stint
Passer pyrrhonotus	Sind Sparrow
Pandion haliaetus	Osprey
Clamator jacobinus	Pied Cuckoo
Emberiza striolata	Striolated Bunting
Charadrius dubius	Little Ringed Plover
Erpornis zantholeuca	White-bellied Erpornis
Sylvia althaea/curruca	Hume's/Lesser Whitethroat
Serinus thibetanus	Tibetan Serin
Vanellus duvaucelii	River Lapwing
Anas querquedula	Garganey
Anthus nilghiriensis	Nilgiri Pipit
Psilopogon haemacephalus	Coppersmith Barbet
Sylvia hortensis/crassirostris	Western/Eastern Orphean Warbler
Hypsipetes leucocephalus	Black Bulbul
Pteruthius melanotis	Black-eared Shrike-Babbler
Dicaeum agile/erythrorhynchos	Thick-billed/Pale-billed Flowerpecker
Locustella thoracica	Spotted Bush-Warbler
Dicaeum chrysorrheum	Yellow-vented Flowerpecker
Luscinia phaenicuroides	White-bellied Redstart
Turnix suscitator	Barred Buttonquail
Sturnidae sp.	myna/starling sp.
Turdus dissimilis	Black-breasted Thrush
Pelecanus philippensis	Spot-billed Pelican
Trochalopteron erythrocephalum	Chestnut-crowned Laughingthrush
Abroscopus schisticeps	Black-faced Warbler
Certhia manipurensis	Hume's Treecreeper
Terpsiphone affinis	Blyth's Paradise-Flycatcher
Apus pacificus/salimalii/leuconyx/cooki	fork-tailed swift sp.
Muscicapa dauurica	Asian Brown Flycatcher
Copsychus saularis	Oriental Magpie-Robin
Actinodura nipalensis	Hoary-throated Barwing
Zoothera marginata	Dark-sided Thrush
Hieraaetus pennatus	Booted Eagle
Stachyris oglei	Snowy-throated Babbler
Sporaeginthus formosus	Green Avadavat
Orthotomus sutorius	Common Tailorbird
Esacus recurvirostris	Great Thick-knee
Psilopogon malabaricus	Malabar Barbet
Psarisomus dalhousiae	Long-tailed Broadbill
Prinia superciliaris	Hill Prinia
Aceros nipalensis	Rufous-necked Hornbill
Emberiza spodocephala	Black-faced Bunting
Halcyon pileata	Black-capped Kingfisher
Psittacula caniceps	Nicobar Parakeet
Chloris spinoides	Yellow-breasted Greenfinch
Anser erythropus	Lesser White-fronted Goose
Lalage melaschistos	Black-winged Cuckooshrike
Iole virescens	Olive Bulbul
Machlolophus xanthogenys	Black-lored Tit
Leptoptilos javanicus/dubius	Lesser/Greater Adjutant
Pycnonotus sp.	Pycnonotus sp.
Anas querquedula/crecca	Garganey/Green-winged Teal
Sitta formosa	Beautiful Nuthatch
Columba pulchricollis	Ashy Wood-Pigeon
Ardeidae sp.	heron sp.
Suthora fulvifrons	Fulvous Parrotbill
Psittiparus bakeri	Rufous-headed Parrotbill
Nectariniidae sp. (sunbird sp.)	sunbird sp.
Parus monticolus	Green-backed Tit
Saroglossa spiloptera	Spot-winged Starling
Anas platyrhynchos	Mallard
Certhia sp.	treecreeper sp.
Turdoides earlei	Striated Babbler
Pyrrhula erythrocephala	Red-headed Bullfinch
Cyanoderma chrysaeum	Golden Babbler
Horornis fortipes	Brownish-flanked Bush-Warbler
Dumetia hyperythra	Tawny-bellied Babbler
Turdoides longirostris	Slender-billed Babbler
Hydrophasianus chirurgus	Pheasant-tailed Jacana
Dicrurus sp.	drongo sp.
Machlolophus spilonotus	Yellow-cheeked Tit
Phalacrocoracidae sp.	cormorant sp.
Sylvia curruca	Lesser Whitethroat
Columba livia	Rock Pigeon
Calidris temminckii	Temminck's Stint
Cuculus canorus	Common Cuckoo
Cyornis pallipes	White-bellied Blue-Flycatcher
Ardea cinerea	Gray Heron
Gruidae sp.	crane sp.
Zapornia akool	Brown Crake
Dendrocopos canicapillus	Gray-capped Woodpecker
Mirafra cantillans	Singing Bushlark
Paradoxornis guttaticollis	Spot-breasted Parrotbill
Locustella davidi	Baikal Bush-Warbler
Horornis sp.	bush-warbler sp.
Arborophila torqueola	Hill Partridge
Anous stolidus	Brown Noddy
Synoicus/Coturnix sp.	old world quail sp.
Regulus regulus	Goldcrest
Cyornis poliogenys	Pale-chinned Blue-Flycatcher
Pericrocotus roseus	Rosy Minivet
Enicurus immaculatus	Black-backed Forktail
Pericrocotus brevirostris	Short-billed Minivet
Brachypteryx major	Nilgiri Shortwing
Chalcophaps indica	Asian Emerald Dove
Phoenicurus schisticeps	White-throated Redstart
Ictinaetus malaiensis	Black Eagle
Strix aluco	Tawny Owl
Treron phoenicopterus	Yellow-footed Pigeon
Porphyrio poliocephalus	Gray-headed Swamphen
Psilopogon viridis	White-cheeked Barbet
Motacilla sp.	wagtail sp.
Cephalopyrus flammiceps	Fire-capped Tit
Ficedula hodgsoni	Pygmy Blue-Flycatcher
Nucifraga multipunctata	Kashmir Nutcracker
Alaemon alaudipes	Greater Hoopoe-Lark
Anthus richardi/rufulus	Richard's/Paddyfield Pipit
Haliaeetus leucoryphus	Pallas's Fish-Eagle
Anthus rufulus	Paddyfield Pipit
Irena puella	Asian Fairy-bluebird
Ciconiidae sp.	stork sp.
Netta rufina	Red-crested Pochard
Phoenicurus sp.	redstart sp.
Tickellia hodgsoni	Broad-billed Warbler
Cettia cetti	Cetti's Warbler
Turnix sylvaticus	Small Buttonquail
Phaenicophaeus tristis	Green-billed Malkoha
Rallina [undescribed form]	Great Nicobar Crake (undescribed form)
Emberiza pusilla	Little Bunting
Phoenicurus hodgsoni	Hodgson's Redstart
Ninox scutulata	Brown Boobook
Trochalopteron fairbanki	Kerala Laughingthrush
Pteruthius rufiventer	Black-headed Shrike-Babbler
Aythya fuligula	Tufted Duck
Dinopium javanense	Common Flameback
Pluvialis sp.	Black-bellied Plover/golden-plover sp.
Agropsar sturninus	Daurian Starling
Apus affinis	Little Swift
Gallinago gallinago	Common Snipe
Leptocoma brasiliana	Van Hasselt's Sunbird
Otus alius	Nicobar Scops-Owl
Ixobrychus cinnamomeus	Cinnamon Bittern
Coturnix coturnix	Common Quail
Anthracoceros coronatus	Malabar Pied-Hornbill
Motacilla flava	Western Yellow Wagtail
Sturnia erythropygia	White-headed Starling
Pterocles orientalis	Black-bellied Sandgrouse
Ixos mcclellandii	Mountain Bulbul
Pnoepyga albiventer	Scaly-breasted Cupwing
Sitta sp.	nuthatch sp.
Larus argentatus	Herring Gull
Heterophasia gracilis	Gray Sibia
Spelaeornis chocolatinus	Long-tailed Wren-Babbler
Pterocles senegallus	Spotted Sandgrouse
Turdus eunomus	Dusky Thrush
Numenius arquata	Eurasian Curlew
Artamus leucorynchus	White-breasted Woodswallow
Dicaeum cruentatum	Scarlet-backed Flowerpecker
Stercorarius pomarinus	Pomarine Jaeger
Podiceps cristatus	Great Crested Grebe
Prinia rufescens	Rufescent Prinia
Pycnonotus atriceps	Black-headed Bulbul
Carpodacus edwardsii	Dark-rumped Rosefinch
Sitta castanea	Indian Nuthatch
Locustella luteoventris	Brown Bush-Warbler
Chrysomma sinense	Yellow-eyed Babbler
Bucanetes githagineus	Trumpeter Finch
Tarsiger cyanurus	Red-flanked Bluetail
Tringa erythropus	Spotted Redshank
Cuculus canorus/optatus	Common/Oriental Cuckoo
Monticola solitarius	Blue Rock-Thrush
Batrachostomus hodgsoni	Hodgson's Frogmouth
Sasia ochracea	White-browed Piculet
Corvus monedula	Eurasian Jackdaw
Puffinus persicus	Persian Shearwater
Anthus trivialis/hodgsoni	Tree/Olive-backed Pipit
Falco sp. (large falcon sp.)	large falcon sp.
Saxicola insignis	White-throated Bushchat
Locustella mandelli	Russet Bush-Warbler
Eudynamys scolopaceus	Asian Koel
Heterophasia pulchella	Beautiful Sibia
Anas zonorhyncha	Eastern Spot-billed Duck
Oenanthe xanthoprymna	Red-tailed Wheatear
Mycerobas carnipes	White-winged Grosbeak
Muscicapa muttui	Brown-breasted Flycatcher
Rhipidura aureola	White-browed Fantail
Yuhina gularis	Stripe-throated Yuhina
Cinclus pallasii	Brown Dipper
Passer rutilans	Russet Sparrow
Spilornis cheela	Crested Serpent-Eagle
Strix ocellata	Mottled Wood-Owl
Ithaginis cruentus	Blood Pheasant
Larinae sp.	gull sp.
Asio otus	Long-eared Owl
Larvivora cyane	Siberian Blue Robin
Strigiformes sp.	owl sp.
Tringa totanus	Common Redshank
Anthus cervinus	Red-throated Pipit
Buteo buteo	Common Buzzard
Pitta sordida	Hooded Pitta
Actinodura egertoni	Rusty-fronted Barwing
Emberiza stewarti	Chestnut-breasted Bunting
Streptopelia senegalensis	Laughing Dove
Garrulus glandarius	Eurasian Jay
Aythya marila	Greater Scaup
Pluvialis squatarola	Black-bellied Plover
Caprimulgus andamanicus	Andaman Nightjar
Anas poecilorhyncha	Indian Spot-billed Duck
Cygnus olor	Mute Swan
Grus grus	Common Crane
Acrocephalus dumetorum	Blyth's Reed-Warbler
Lophophorus sclateri	Sclater's Monal
Pycnonotus luteolus	White-browed Bulbul
Anthus rubescens	American Pipit
Phylloscopus inornatus/humei	Yellow-browed/Hume's Warbler
Loxia curvirostra	Red Crossbill
Threskiornithidae sp. (ibis sp.)	ibis sp.
Riparia riparia	Bank Swallow
Psilopogon duvaucelii	Blue-eared Barbet
Heterophasia capistrata	Rufous Sibia
Bucanetes mongolicus	Mongolian Finch
Pluvialis apricaria/dominica/fulva	golden-plover sp.
Sturnus vulgaris	European Starling
Turdus unicolor	Tickell's Thrush
Phylloscopus fuligiventer	Smoky Warbler
Egretta gularis	Western Reef-Heron
Gyps tenuirostris	Slender-billed Vulture
Indicator xanthonotus	Yellow-rumped Honeyguide
Ducula nicobarica	Nicobar Imperial-Pigeon
Phylloscopus chloronotus	Pale-rumped Warbler
Calidris subminuta	Long-toed Stint
Eremopterix griseus	Ashy-crowned Sparrow-Lark
Calidris ruficollis/minuta	Red-necked/Little Stint
Perdicula manipurensis	Manipur Bush-Quail
Paradoxornis flavirostris	Black-breasted Parrotbill
Sylvia nana	Asian Desert Warbler
Limosa sp.	godwit sp.
Procellariidae sp. (shearwater sp.)	shearwater sp.
Hemixos flavala	Ashy Bulbul
Carpodacus rodopeplus	Spot-winged Rosefinch
Leiothrix argentauris	Silver-eared Mesia
Phoenicurus ochruros	Black Redstart
Hypocolius ampelinus	Hypocolius
Schoeniparus rufogularis	Rufous-throated Fulvetta
Ficedula sapphira	Sapphire Flycatcher
Columba hodgsonii	Speckled Wood-Pigeon
Pseudopodoces humilis	Ground Tit
Muscicapa ferruginea	Ferruginous Flycatcher
Tadorna tadorna	Common Shelduck
Picidae sp.	woodpecker sp.
Scolopax rusticola	Eurasian Woodcock
Phoenicurus erythrogastrus	White-winged Redstart
Falco naumanni	Lesser Kestrel
Turdoides subrufa	Rufous Babbler
Chloropsis jerdoni	Jerdon's Leafbird
Seicercus poliogenys	Gray-cheeked Warbler
Minla annectens	Rufous-backed Sibia
Dromaius novaehollandiae	Emu
Prunella rubeculoides	Robin Accentor
Timalia pileata	Chestnut-capped Babbler
Eumyias sordidus	Dull-blue Flycatcher
Aethopyga gouldiae	Gould's Sunbird
Dinopium shorii	Himalayan Flameback
Pycnonotus cafer	Red-vented Bulbul
Arenaria interpres	Ruddy Turnstone
Limosa lapponica	Bar-tailed Godwit
Nisaetus limnaeetus/cirrhatus	Changeable/Crested Hawk-Eagle
Anas crecca	Green-winged Teal
Chaetornis striata	Bristled Grassbird
Columba sp.	Columba sp.
Ianthocincla albogularis	White-throated Laughingthrush
Esacus magnirostris	Beach Thick-knee
Eremopterix nigriceps	Black-crowned Sparrow-Lark
Tringa ochropus	Green Sandpiper
Pyrrhula erythaca	Gray-headed Bullfinch
Lophophorus impejanus	Himalayan Monal
Phalacrocorax fuscicollis	Indian Cormorant
Trochalopteron imbricatum	Bhutan Laughingthrush
Pastor roseus	Rosy Starling
Hippolais sp.	Hippolais sp.
Abroscopus superciliaris	Yellow-bellied Warbler
Yuhina nigrimenta	Black-chinned Yuhina
Tetraogallus himalayensis	Himalayan Snowcock
Saxicola caprata	Pied Bushchat
Schoeniparus dubius	Rusty-capped Fulvetta
Limosa limosa	Black-tailed Godwit
Ninox obscura	Hume's Boobook
Parulidae sp.	warbler sp. (Parulidae sp.)
Pycnonotus fuscoflavescens	Andaman Bulbul
Ichthyaetus leucophthalmus	White-eyed Gull
Delichon dasypus	Asian House-Martin
Megalurus palustris	Striated Grassbird
Ixobrychus sinensis	Yellow Bittern
Ardeola grayii	Indian Pond-Heron
Graminicola bengalensis	Indian Grassbird
Lanius cristatus	Brown Shrike
Pavo cristatus (Domestic type)	Indian Peafowl (Domestic type)
Hirundapus giganteus	Brown-backed Needletail
Mirafra erythroptera	Indian Bushlark
Fulvetta vinipectus	White-browed Fulvetta
Upupa epops	Eurasian Hoopoe
Gyps fulvus	Eurasian Griffon
Galloperdix spadicea/lunulata	Red/Painted Spurfowl
Pterocles exustus	Chestnut-bellied Sandgrouse
Tyrannidae sp.	flycatcher sp. (Tyrannidae sp.)
Aegithalos leucogenys	White-cheeked Tit
Yuhina bakeri	White-naped Yuhina
Rhipidura albicollis/aureola	White-throated/White-browed Fantail
Phylloscopus humei	Hume's Warbler
Niltava sundara	Rufous-bellied Niltava
Aplonis panayensis	Asian Glossy Starling
Larus cachinnans	Caspian Gull
Rostratula benghalensis	Greater Painted-Snipe
Urocissa erythroryncha	Red-billed Blue-Magpie
Geopelia striata	Zebra Dove
Stachyris sp.	Stachyris sp.
Pomatorhinus horsfieldii	Indian Scimitar-Babbler
Passer montanus	Eurasian Tree Sparrow
Glareola lactea	Small Pratincole
Apus pallidus	Pallid Swift
Carduelis carduelis	European Goldfinch
Ficedula strophiata	Rufous-gorgeted Flycatcher
Sypheotides indicus	Lesser Florican
Cyanoderma pyrrhops	Black-chinned Babbler
Chloropsis aurifrons	Golden-fronted Leafbird
Emberiza melanocephala/bruniceps	Black-headed/Red-headed Bunting
Cuculus saturatus	Himalayan Cuckoo
Acrocephalus sp.	Acrocephalus sp.
Strix leptogrammica	Brown Wood-Owl
Corvus sp. (crow sp.)	crow sp.
Phylloscopus cantator	Yellow-vented Warbler
Egretta sacra	Pacific Reef-Heron
Prinia crinigera	Striated Prinia
Psittacula cyanocephala	Plum-headed Parakeet
Psittacula finschii	Gray-headed Parakeet
Aerodramus sp.	dark swiftlet sp.
Alcippe nipalensis	Nepal Fulvetta
Passeriformes sp.	passerine sp.
Prunella himalayana	Himalayan Accentor
Pluvialis fulva	Pacific Golden-Plover
Collocalia/Aerodramus sp.	swiftlet sp.
Onychoprion fuscatus	Sooty Tern
Calandrella brachydactyla	Greater Short-toed Lark
Ketupa zeylonensis	Brown Fish-Owl
Accipitriformes/Falconiformes sp.	diurnal raptor sp.
Megapomatorhinus hypoleucos	Large Scimitar-Babbler
Butastur teesa	White-eyed Buzzard
Hirundapus caudacutus	White-throated Needletail
Prunella immaculata	Maroon-backed Accentor
Muscicapa sibirica	Dark-sided Flycatcher
Fregata sp.	frigatebird sp.
Leptocoma minima	Crimson-backed Sunbird
Rhipidura albogularis/aureola	Spot-breasted/White-browed Fantail
Gyps bengalensis	White-rumped Vulture
Acrocephalus bistrigiceps	Black-browed Reed-Warbler
Megalaimidae sp.	asian barbet sp.
Rissa tridactyla	Black-legged Kittiwake
Dendrocygna javanica	Lesser Whistling-Duck
Chrysococcyx xanthorhynchus	Violet Cuckoo
Aves sp.	bird sp.
Apus acuticauda	Dark-rumped Swift
Dendronanthus indicus	Forest Wagtail
Dryocopus hodgei	Andaman Woodpecker
Dicaeum concolor	Nilgiri Flowerpecker
Calandrella acutirostris	Hume's Lark
Gyps himalayensis	Himalayan Griffon
Lonchura atricapilla	Chestnut Munia
Glaucidium brodiei	Collared Owlet
Sula sula	Red-footed Booby
Gallicrex cinerea	Watercock
Clanga clanga	Greater Spotted Eagle
Stercorarius longicaudus	Long-tailed Jaeger
Haliaeetus albicilla	White-tailed Eagle
Anthus similis	Long-billed Pipit
Calandrella brachydactyla/acutirostris	Greater Short-toed/Hume's Lark
Oriolus tenuirostris	Slender-billed Oriole
Emberiza melanocephala	Black-headed Bunting
Aegithina nigrolutea	White-tailed Iora
Arachnothera longirostra	Little Spiderhunter
Anthus godlewskii	Blyth's Pipit
Dinopium benghalense	Black-rumped Flameback
Horornis brunnescens	Hume's Bush-Warbler
Turdoides sp.	Turdoides sp.
Gallinago nemoricola	Wood Snipe
Buteo hemilasius	Upland Buzzard
Ploceus benghalensis	Bengal Weaver
Houbaropsis bengalensis	Bengal Florican
Prinia cinereocapilla	Gray-crowned Prinia
Passer sp.	Passer sp.
Anthropoides virgo	Demoiselle Crane
Motacilla flava/tschutschensis	Western/Eastern Yellow Wagtail
Anser anser (Domestic type)	Graylag Goose (Domestic type)
Zoothera mollissima	Alpine Thrush
Anser cygnoides	Swan Goose
Trochalopteron squamatum	Blue-winged Laughingthrush
Carpodacus rodochroa	Pink-browed Rosefinch
Sturnia blythii	Malabar Starling
Muscicapa striata	Spotted Flycatcher
Apus pacificus	Pacific Swift
Hirundapus cochinchinensis	Silver-backed Needletail
Pica pica	Eurasian Magpie
Coturnix coromandelica	Rain Quail
Sylviparus modestus	Yellow-browed Tit
Aquila sp.	Aquila sp.
Turnix sp.	buttonquail sp.
Limnodromus scolopaceus	Long-billed Dowitcher
Actinodura strigula	Chestnut-tailed Minla
Pericrocotus speciosus	Scarlet Minivet
Serinus pusillus	Fire-fronted Serin
Pericrocotus divaricatus	Ashy Minivet
Riparia chinensis	Gray-throated Martin
Charadrius hiaticula	Common Ringed Plover
Bambusicola fytchii	Mountain Bamboo-Partridge
Phoenicurus leucocephalus	White-capped Redstart
Caprimulgidae sp.	nightjar sp.
Aethopyga ignicauda	Fire-tailed Sunbird
Prinia cinerascens	Swamp Prinia
Hirundo rustica	Barn Swallow
Calidris canutus	Red Knot
Glareola pratincola/maldivarum	Collared/Oriental Pratincole
Arachnothera magna	Streaked Spiderhunter
Picus xanthopygaeus	Streak-throated Woodpecker
Prinia hodgsonii	Gray-breasted Prinia
Pyrrhoplectes epauletta	Gold-naped Finch
Brachypteryx stellata	Gould's Shortwing
Nyctyornis athertoni	Blue-bearded Bee-eater
Turdus simillimus	Indian Blackbird
Ficedula westermanni	Little Pied Flycatcher
Sphenocichla roberti	Chevron-breasted Babbler
Larus sp.	Larus sp.
Jynx torquilla	Eurasian Wryneck
Gallinula chloropus	Eurasian Moorhen
Neophron percnopterus	Egyptian Vulture
Hemiprocne coronata	Crested Treeswift
Tyto alba	Barn Owl
Stercorarius maccormicki	South Polar Skua
Clanga pomarina/clanga	Lesser/Greater Spotted Eagle
Cisticola exilis	Golden-headed Cisticola
Machlolophus nuchalis	White-naped Tit
Nettapus coromandelianus	Cotton Pygmy-Goose
Anas formosa	Baikal Teal
Phoenicurus auroreus	Daurian Redstart
Lanius collurioides	Burmese Shrike
Geokichla sibirica	Siberian Thrush
Amaurornis cinerea	White-browed Crake
Sternula albifrons	Little Tern
Buteo refectus	Himalayan Buzzard
Aquila nipalensis	Steppe Eagle
Mirafra sp.	Mirafra sp.
Pyrrhocorax pyrrhocorax	Red-billed Chough
Bubo coromandus	Dusky Eagle-Owl
Ixobrychus minutus	Little Bittern
Ianthocincla nuchalis	Chestnut-backed Laughingthrush
Montifringilla ruficollis	Rufous-necked Snowfinch
Galerida deva	Tawny Lark
Apus nipalensis	House Swift
Pittidae sp.	Pitta sp. (genus Erythropitta/Hydrornis/Pitta)
Pycnonotus priocephalus	Gray-headed Bulbul
Apus leuconyx	Blyth's Swift
Chlidonias leucopterus	White-winged Tern
Anous tenuirostris	Lesser Noddy
Cyornis banyumas	Hill Blue-Flycatcher
Leiothrix lutea	Red-billed Leiothrix
Anser/Chen/Branta sp.	goose sp.
Ninox affinis	Andaman Boobook
Turdus feae	Gray-sided Thrush
Cercotrichas galactotes	Rufous-tailed Scrub-Robin
Calidris ruficollis	Red-necked Stint
Cyornis magnirostris	Large Blue-Flycatcher
Accipiter badius	Shikra
Megapomatorhinus mcclellandi	Spot-breasted Scimitar-Babbler
Motacilla tschutschensis	Eastern Yellow Wagtail
Iduna caligata/rama	Booted/Sykes's Warbler
Cyornis unicolor	Pale Blue-Flycatcher
Trochalopteron chrysopterum	Assam Laughingthrush
Batrachostomus moniliger	Sri Lanka Frogmouth
Mergus merganser	Common Merganser
Anatinae sp.	duck sp.
Ducula aenea	Green Imperial-Pigeon
Petrochelidon fluvicola	Streak-throated Swallow
Cursorius cursor	Cream-colored Courser
Dendrocopos analis	Freckle-breasted Woodpecker
Sterninae sp.	tern sp.
Bradypterus sp.	Bradypterus sp.
Ficedula albicilla	Taiga Flycatcher
Mulleripicus pulverulentus	Great Slaty Woodpecker
Psittacula longicauda	Long-tailed Parakeet
Spelaeornis troglodytoides	Bar-winged Wren-Babbler
Cinnyris asiaticus	Purple Sunbird
Lalage melanoptera	Black-headed Cuckooshrike
Sturnia malabarica	Chestnut-tailed Starling
Liocichla bugunorum	Bugun Liocichla
Athene brama	Spotted Owlet
Sylvia althaea	Hume's Whitethroat
Sitta cinnamoventris	Chestnut-bellied Nuthatch
Pterocles sp.	sandgrouse sp.
Falco sp.	falcon sp.
Iduna sp.	Iduna sp.
Phaethon lepturus	White-tailed Tropicbird
Pitta brachyura	Indian Pitta
Brachypteryx montana	White-browed Shortwing
Sylvia sp.	Sylvia sp.
Turdus viscivorus	Mistle Thrush
Grandala coelicolor	Grandala
Ficedula sp.	Ficedula sp.
Ducula bicolor	Pied Imperial-Pigeon
Otus sp.	scops-owl sp.
Conostoma aemodium	Great Parrotbill
Harpactes erythrocephalus	Red-headed Trogon
Stercorarius sp.	jaeger/skua sp.
Streptopelia decaocto	Eurasian Collared-Dove
Hierococcyx sp.	hawk-cuckoo sp.
Polyplectron bicalcaratum	Gray Peacock-Pheasant
Lophophanes dichrous	Gray-crested Tit
Dicaeum melanoxanthum	Yellow-bellied Flowerpecker
Prinia socialis	Ashy Prinia
Calidris ferruginea	Curlew Sandpiper
Zoothera monticola	Long-billed Thrush
Tephrodornis virgatus/pondicerianus	Large/Common Woodshrike
Spizixos canifrons	Crested Finchbill
Dendrocopos cathpharius	Crimson-breasted Woodpecker
Tringa stagnatilis	Marsh Sandpiper
Buteo sp.	Buteo sp.
Tyto longimembris	Australasian Grass-Owl
Melophus lathami	Crested Bunting
Leucosticte nemoricola	Plain Mountain-Finch
Dicrurus macrocercus/leucophaeus	Black/Ashy Drongo
Vanellus gregarius	Sociable Lapwing
Napothera malacoptila	Long-billed Wren-Babbler
Circus melanoleucos	Pied Harrier
Sturnia pagodarum	Brahminy Starling
Aquila heliaca	Imperial Eagle
Acrocephalus stentoreus	Clamorous Reed-Warbler
Ficedula subrubra	Kashmir Flycatcher
Elanus caeruleus	Black-shouldered Kite
Psittacula derbiana	Derbyan Parakeet
Sterna aurantia	River Tern
Clamator glandarius	Great Spotted Cuckoo
Sternula saundersi	Saunders's Tern
Hydrornis cyaneus	Blue Pitta
Cacomantis passerinus	Gray-bellied Cuckoo
Haliastur indus	Brahminy Kite
Francolinus pondicerianus	Gray Francolin
Prunella fulvescens	Brown Accentor
Circus macrourus/pygargus	Pallid/Montagu's Harrier
Fringillidae sp.	finch sp.
Tragopan satyra	Satyr Tragopan
Chroicocephalus brunnicephalus	Brown-headed Gull
Petronia xanthocollis	Chestnut-shouldered Petronia
Fregata minor	Great Frigatebird
Clanga hastata/clanga	Indian/Greater Spotted Eagle
Prunella collaris	Alpine Accentor
Apus melba	Alpine Swift
Cuculidae sp.	cuckoo sp. (Cuculidae sp.)
Enicurus leschenaulti	White-crowned Forktail
Pellorneum palustre	Marsh Babbler
Galerida malabarica	Malabar Lark
Calidris pugnax	Ruff
Yuhina occipitalis	Rufous-vented Yuhina
Buceros bicornis	Great Hornbill
Limnodromus semipalmatus	Asian Dowitcher
Accipiter trivirgatus	Crested Goshawk
Chrysocolaptes guttacristatus	Greater Flameback
Accipitridae sp. (hawk sp.)	hawk sp.
Falco peregrinus	Peregrine Falcon
Locustella lanceolata	Lanceolated Warbler
Hierococcyx varius	Common Hawk-Cuckoo
Phoenicopteridae sp.	flamingo sp.
Aegithalos concinnus	Black-throated Tit
Emberiza fucata	Chestnut-eared Bunting
Geokichla wardii	Pied Thrush
Phylloscopus xanthoschistos	Gray-hooded Warbler
Seicercus burkii	Golden-spectacled Warbler
Dendrocopos mahrattensis	Yellow-crowned Woodpecker
Tragopan temminckii	Temminck's Tragopan
Acrocephalus melanopogon	Moustached Warbler
Sturnia malabarica/blythii	Chestnut-tailed/Malabar Starling
Cuculus micropterus	Indian Cuckoo
Dicaeum ignipectus	Fire-breasted Flowerpecker
Dendrocitta/Crypsirina/Temnurus sp.	treepie sp.
Haematopus ostralegus	Eurasian Oystercatcher
Oriolus chinensis	Black-naped Oriole
Buteo rufinus	Long-legged Buzzard
Pernis ptilorhynchus	Oriental Honey-buzzard
Ficedula albicilla/parva	Taiga/Red-breasted Flycatcher
Bubo bubo	Eurasian Eagle-Owl
Ardea sp.	Ardea sp.
Gecinulus grantia	Pale-headed Woodpecker
Anas platyrhynchos (Domestic type)	Mallard (Domestic type)
Pellorneum albiventre	Spot-throated Babbler
Pteruthius flaviscapis	Pied Shrike-Babbler
Glaucidium cuculoides	Asian Barred Owlet
Actitis hypoleucos	Common Sandpiper
Pericrocotus solaris	Gray-chinned Minivet
Aerodramus unicolor	Indian Swiftlet
Locustella kashmirensis	West Himalayan Bush-Warbler
Ianthocincla gularis	Rufous-vented Laughingthrush
Prinia sp.	prinia sp.
Suthora nipalensis	Black-throated Parrotbill
Jacanidae sp.	jacana sp.
Cecropis daurica	Red-rumped Swallow
Galloperdix lunulata	Painted Spurfowl
Oenanthe deserti	Desert Wheatear
Certhia nipalensis	Rusty-flanked Treecreeper
Hierococcyx sparverioides	Large Hawk-Cuckoo
Lonchura punctulata	Scaly-breasted Munia
Hypothymis azurea	Black-naped Monarch
Merops philippinus	Blue-tailed Bee-eater
Parus cinereus	Cinereous Tit
Carpodacus thura	Himalayan White-browed Rosefinch
Ibidorhyncha struthersii	Ibisbill
Pachycephala cinerea	Mangrove Whistler
Accipiter sp.	Accipiter sp.
Estrildidae sp.	estrildid finch sp.
Urosphena pallidipes	Pale-footed Bush-Warbler
Gyps himalayensis/fulvus	Himalayan/Eurasian Griffon
Ardea purpurea	Purple Heron
Tephrodornis virgatus	Large Woodshrike
Ploceus megarhynchus	Yellow Weaver
Perdicula erythrorhyncha	Painted Bush-Quail
Motacilla alba/maderaspatensis	White/White-browed Wagtail
Hirundo smithii	Wire-tailed Swallow
Acrocephalus orientalis	Oriental Reed-Warbler
Ephippiorhynchus asiaticus	Black-necked Stork
Polyplectron chalcurum	Bronze-tailed Peacock-Pheasant
Zapornia bicolor	Black-tailed Crake
Schoeniparus castaneceps	Rufous-winged Fulvetta
Falco subbuteo	Eurasian Hobby
Heterophasia picaoides	Long-tailed Sibia
Rallina eurizonoides	Slaty-legged Crake
Dinopium javanense/Chrysocolaptes guttacristatus	Common/Greater Flameback
Motacilla maderaspatensis	White-browed Wagtail
Periparus rufonuchalis	Black-breasted Tit
Trochalopteron affine	Black-faced Laughingthrush
Pellorneum tickelli	Buff-breasted Babbler
Cyanoderma ruficeps	Rufous-capped Babbler
Turdus boulboul	Gray-winged Blackbird
Phylloscopus trochiloides/plumbeitarsus	Greenish/Two-barred Warbler
Prunella atrogularis	Black-throated Accentor
Ammomanes deserti	Desert Lark
Turdinus abbotti	Abbott's Babbler
Sterna acuticauda	Black-bellied Tern
Apus apus	Common Swift
Phylloscopus reguloides	Blyth's Leaf Warbler
Columba elphinstonii	Nilgiri Wood-Pigeon
Fregata ariel	Lesser Frigatebird
Oceanodroma monorhis	Swinhoe's Storm-Petrel
Passer hispaniolensis	Spanish Sparrow
Treron curvirostra	Thick-billed Pigeon
Culicicapa ceylonensis	Gray-headed Canary-Flycatcher
Pavo cristatus	Indian Peafowl
Picus canus	Gray-headed Woodpecker
Carpodacus rubicilloides	Streaked Rosefinch
Circus spilonotus	Eastern Marsh-Harrier
Acrocephalus agricola/dumetorum	Paddyfield/Blyth's Reed-Warbler
Salpornis spilonotus	Indian Spotted-Creeper
Saxicola ferreus	Gray Bushchat
Anthracoceros albirostris	Oriental Pied-Hornbill
Delichon nipalense	Nepal House-Martin
Mycerobas icterioides	Black-and-yellow Grosbeak
Gallinago solitaria	Solitary Snipe
Cypsiurus balasiensis	Asian Palm-Swift
Pinicola subhimachala	Crimson-browed Finch
Pteruthius aeralatus	Blyth's Shrike-Babbler
Aerodramus fuciphagus	White-nest Swiftlet
Dendrocopos himalayensis	Himalayan Woodpecker
Ianthocincla caerulata	Gray-sided Laughingthrush
Cursorius coromandelicus	Indian Courser
Lonchura striata	White-rumped Munia
Gypaetus barbatus	Lammergeier
Anthus roseatus	Rosy Pipit
Gallinula chloropus/galeata	Eurasian Moorhen/Common Gallinule
Anorrhinus austeni	Brown Hornbill
Pellorneum ruficeps	Puff-throated Babbler
Tringa glareola	Wood Sandpiper
Carpodacus erythrinus	Common Rosefinch
Ichthyophaga humilis/ichthyaetus	Lesser/Gray-headed Fish-Eagle
Stachyris nigriceps	Gray-throated Babbler
Myophonus horsfieldii	Malabar Whistling-Thrush
Cyornis rubeculoides	Blue-throated Flycatcher
Merops persicus/philippinus	Blue-cheeked/Blue-tailed Bee-eater
Lanius sp.	shrike sp.
Pycnonotus cafer/jocosus	Red-vented/Red-whiskered Bulbul
Ketupa flavipes	Tawny Fish-Owl
Dendrocitta bayleii	Andaman Treepie
Calliope calliope	Siberian Rubythroat
Apus sp.	Apus sp.
Strix nivicolum	Himalayan Owl
Turdoides affinis	Yellow-billed Babbler
Ichthyophaga humilis	Lesser Fish-Eagle
Asarcornis scutulata	White-winged Duck
Chelidorhynx hypoxantha	Yellow-bellied Fairy-Fantail
Anthus hodgsoni	Olive-backed Pipit
Anas falcata	Falcated Duck
Iduna aedon	Thick-billed Warbler
Aviceda jerdoni	Jerdon's Baza
Caprimulgus affinis	Savanna Nightjar
Pericrocotus erythropygius	White-bellied Minivet
Surniculus lugubris	Square-tailed Drongo-Cuckoo
Anthus sylvanus	Upland Pipit
Pomatorhinus ruficollis	Streak-breasted Scimitar-Babbler
Calonectris diomedea	Cory's Shearwater
Arborophila mandellii	Chestnut-breasted Partridge
Ficedula nigrorufa	Black-and-rufous Flycatcher
Phaethon aethereus	Red-billed Tropicbird
Fringilla montifringilla	Brambling
Accipiter nisus	Eurasian Sparrowhawk
Alcippe poioicephala	Brown-cheeked Fulvetta
Coracias benghalensis	Indian Roller
Marmaronetta angustirostris	Marbled Teal
Surniculus dicruroides	Fork-tailed Drongo-Cuckoo
Dicrurus caerulescens	White-bellied Drongo
Chlamydotis macqueenii	Macqueen's Bustard
Gampsorhynchus rufulus	White-hooded Babbler
Locustella naevia	Common Grasshopper-Warbler
Dicrurus aeneus	Bronzed Drongo
Arachnothera sp.	spiderhunter sp.
Otus spilocephalus	Mountain Scops-Owl
Charadriidae sp.	plover sp.
Fulvetta manipurensis	Streak-throated Fulvetta
Threskiornis melanocephalus	Black-headed Ibis
Rallus aquaticus	Water Rail
Rhopocichla atriceps	Dark-fronted Babbler
Caprimulgus asiaticus	Indian Nightjar
Pycnonotus gularis	Flame-throated Bulbul
Anas albogularis	Andaman Teal
Dendrocygna bicolor	Fulvous Whistling-Duck
Hypsipetes virescens	Nicobar Bulbul
Cyornis sp.	blue-flycatcher sp.
Liocichla phoenicea	Red-faced Liocichla
Charadriiformes sp.	shorebird sp.
Ardenna pacifica	Wedge-tailed Shearwater
Phalacrocorax carbo	Great Cormorant
Halcyon coromanda	Ruddy Kingfisher
Schoeniparus cinereus	Yellow-throated Fulvetta
Leptoptilos javanicus	Lesser Adjutant
Phylloscopus affinis	Tickell's Leaf Warbler
Phalaropus fulicarius	Red Phalarope
Prunella strophiata	Rufous-breasted Accentor
Nisaetus sp.	Nisaetus sp.
Cygnus atratus	Black Swan
Podicipedidae sp.	grebe sp.
Pucrasia macrolopha	Koklass Pheasant
Carpodacus nipalensis	Dark-breasted Rosefinch
Tarsiger rufilatus	Himalayan Bluetail
Phylloscopus magnirostris	Large-billed Leaf Warbler
Brachypteryx albiventris	White-bellied Shortwing
Tesia cyaniventer	Gray-bellied Tesia
Acridotheres sp. (black myna sp.)	black myna sp.
Stercorarius pomarinus/parasiticus	Pomarine/Parasitic Jaeger
Psittiparus gularis	Gray-headed Parrotbill
Treron sphenurus	Wedge-tailed Pigeon
Anas acuta	Northern Pintail
Phoeniconaias minor	Lesser Flamingo
Milvus migrans	Black Kite
Bucerotidae sp.	hornbill sp.
Gelochelidon nilotica	Gull-billed Tern
Prinia buchanani	Rufous-fronted Prinia
Anser indicus	Bar-headed Goose
Schoenicola platyurus	Broad-tailed Grassbird
Anas clypeata	Northern Shoveler
Amandava amandava	Red Avadavat
Cecropis striolata	Striated Swallow
Stachyris humei	Blackish-breasted Babbler
Gallinago gallinago/stenura	Common/Pin-tailed Snipe
Recurvirostra avosetta	Pied Avocet
Zapornia fusca	Ruddy-breasted Crake
Rhipidura sp.	fantail sp.
Anthus spinoletta	Water Pipit
Hierococcyx nisicolor	Hodgson's Hawk-Cuckoo
Acridotheres tristis	Common Myna
Burhinus oedicnemus	Eurasian Thick-knee
Gallirallus striatus	Slaty-breasted Rail
Ianthocincla delesserti	Wynaad Laughingthrush
Ciconia sp.	Ciconia sp.
Sterna repressa	White-cheeked Tern
Calidris subruficollis	Buff-breasted Sandpiper
Pericrocotus sp.	minivet sp.
Anser anser	Graylag Goose
Chalcoparia singalensis	Ruby-cheeked Sunbird
Cutia nipalensis	Himalayan Cutia
Psilopogon lineatus	Lineated Barbet
Scolopacidae sp.	Scolopacidae sp.
Athene noctua	Little Owl
Alcedo meninting	Blue-eared Kingfisher
Alophoixus flaveolus	White-throated Bulbul
Cuculus poliocephalus	Lesser Cuckoo
Cettia brunnifrons	Gray-sided Bush-Warbler
Nisaetus nipalensis	Mountain Hawk-Eagle
Oriolus sp.	old world oriole sp.
Lymnocryptes minimus	Jack Snipe
Dicrurus remifer	Lesser Racket-tailed Drongo
Motacilla citreola	Citrine Wagtail
Horornis fortipes/acanthizoides	Brownish-flanked/Yellowish-bellied Bush-Warbler
Carpodacus pulcherrimus	Himalayan Beautiful Rosefinch
Dicaeum minullum	Plain Flowerpecker
Synoicus chinensis	Blue-breasted Quail
Microhierax caerulescens	Collared Falconet
Circus pygargus	Montagu's Harrier
Charadrius asiaticus	Caspian Plover
Anhinga melanogaster	Oriental Darter
Calonectris leucomelas	Streaked Shearwater
Ficedula ruficauda	Rusty-tailed Flycatcher
Paridae sp.	Parid sp.
Aethopyga nipalensis	Green-tailed Sunbird
Francolinus pictus	Painted Francolin
Megaceryle lugubris	Crested Kingfisher
Bubo bengalensis	Rock Eagle-Owl
Ciconia nigra	Black Stork
Lanius phoenicuroides/isabellinus	Red-tailed/Isabelline Shrike
Aquila chrysaetos	Golden Eagle
Pomatorhinus sp.	Pomatorhinus sp.
Chloropsis hardwickii	Orange-bellied Leafbird
Pomatorhinus ferruginosus	Coral-billed Scimitar-Babbler
Turdoides malcolmi	Large Gray Babbler
Turdoides caudata	Common Babbler
Sitta nagaensis	Chestnut-vented Nuthatch
Phylloscopus collybita	Common Chiffchaff
Anthus campestris	Tawny Pipit
Dromas ardeola	Crab Plover
Turdinus brevicaudatus	Streaked Wren-Babbler
Merops persicus	Blue-cheeked Bee-eater
Tadorna ferruginea	Ruddy Shelduck
Trochalopteron austeni	Brown-capped Laughingthrush
Phylloscopus tytleri	Tytler's Leaf Warbler
Plegadis falcinellus	Glossy Ibis
Sterna hirundo	Common Tern
Aquila fasciata	Bonelli's Eagle
Copsychus albiventris	Andaman Shama
Charadrius mongolus/leschenaultii	Lesser/Greater Sand-Plover
Gallinago stenura	Pin-tailed Snipe
Periparus ater	Coal Tit
Grammatoptila striata	Striated Laughingthrush
Terpsiphone paradisi	Indian Paradise-Flycatcher
Chlidonias sp.	Chlidonias sp.
Pycnonotus flavescens	Flavescent Bulbul
Calliope pectardens	Firethroat
Copsychus fulicatus	Indian Robin
Numenius phaeopus/arquata	Whimbrel/Eurasian Curlew
Zoothera salimalii	Himalayan Thrush
Cinnyris jugularis	Olive-backed Sunbird
Coracina macei	Large Cuckooshrike
Cettia castaneocoronata	Chestnut-headed Tesia
Vanellus vanellus	Northern Lapwing
Emberiza schoeniclus	Reed Bunting
Blythipicus pyrrhotis	Bay Woodpecker
Dicrurus macrocercus	Black Drongo
Ardea insignis	White-bellied Heron
Niltava grandis	Large Niltava
Oceanodroma sp.	Oceanodroma sp.
Ciconia ciconia	White Stork
Acridotheres fuscus	Jungle Myna
Phylloscopus pulcher	Buff-barred Warbler
Emberiza buchanani	Gray-hooded Bunting
Merops orientalis	Green Bee-eater
Caprimulgus indicus	Jungle Nightjar
Aegithina tiphia/nigrolutea	Common/White-tailed Iora
Pycnonotus flaviventris	Black-crested Bulbul
Phylloscopus sp.	Phylloscopus sp.
Turdus obscurus	Eyebrowed Thrush
Chrysomma altirostre	Jerdon's Babbler
Zoothera neilgherriensis	Nilgiri Thrush
Alectoris chukar	Chukar
Charadrius leschenaultii	Greater Sand-Plover
SCIENTIFIC NAME	COMMON NAME
Aegithalos niveogularis	White-throated Tit
Centropus andamanensis	Andaman Coucal
Chlidonias hybrida	Whiskered Tern
Pterocles indicus	Painted Sandgrouse
Emberiza aureola	Yellow-breasted Bunting
Xema sabini	Sabine's Gull
Myophonus caeruleus	Blue Whistling-Thrush
Streptopelia sp.	Streptopelia sp.
Butorides striata	Striated Heron
Prinia gracilis	Graceful Prinia
Delichon urbicum	Common House-Martin
Anas strepera	Gadwall
Vanellus malabaricus	Yellow-wattled Lapwing
Accipitridae sp. (eagle sp.)	eagle sp.
Trochalopteron cachinnans	Black-chinned Laughingthrush
Surniculus dicruroides/lugubris	Fork-tailed/Square-tailed Drongo-Cuckoo
Riparia diluta	Pale Sand Martin
Alauda arvensis	Eurasian Skylark
Prinia burnesii	Rufous-vented Prinia
Egretta garzetta	Little Egret
Cinclidium frontale	Blue-fronted Robin
Emberiza bruniceps	Red-headed Bunting
Oriolus oriolus/kundoo	Eurasian/Indian Golden Oriole
Trochalopteron lineatum	Streaked Laughingthrush
Dendrocopos macei	Fulvous-breasted Woodpecker
Charadrius sp.	small plover sp.
Calidris sp. (peep sp.)	peep sp.
Anas penelope	Eurasian Wigeon
Ixobrychus flavicollis	Black Bittern
Sitta yunnanensis	Yunnan Nuthatch
Sterna sumatrana	Black-naped Tern
Phoenicurus frontalis	Blue-fronted Redstart
Sylvia minula	Desert Whitethroat
Calidris melanotos	Pectoral Sandpiper
Progne sp.	martin sp.
Geokichla citrina	Orange-headed Thrush
Tachybaptus ruficollis	Little Grebe
Psittacula krameri	Rose-ringed Parakeet
Lanius meridionalis	Southern Gray Shrike
Carpodacus rubescens	Blanford's Rosefinch
Ammomanes phoenicura	Rufous-tailed Lark
Cisticola sp.	cisticola sp.
Ianthocincla galbana	Yellow-throated Laughingthrush
Phodilus assimilis	Sri Lanka Bay-Owl
Onychoprion fuscatus/anaethetus	Sooty/Bridled Tern
Turdus sp.	Turdus sp.
Lioparus chrysotis	Golden-breasted Fulvetta
Columba punicea	Pale-capped Pigeon
Halcyon smyrnensis	White-throated Kingfisher
Anser serrirostris	Tundra Bean-Goose
Nisaetus limnaeetus	Changeable Hawk-Eagle
Abroscopus albogularis	Rufous-faced Warbler
Cacomantis sp.	Cacomantis sp.
Ceyx erithaca	Black-backed Dwarf-Kingfisher
Certhia hodgsoni	Hodgson's Treecreeper
Melanocorypha maxima	Tibetan Lark
Garrulax merulinus	Spot-breasted Laughingthrush
Phylloscopus borealis	Arctic Warbler
Dendrocitta frontalis	Collared Treepie
Oenanthe sp.	wheatear sp.
Tyto deroepstorffi	Andaman Masked-Owl
Phodilus badius	Oriental Bay-Owl
Phylloscopus nitidus	Green Warbler
Tetraogallus tibetanus	Tibetan Snowcock
Falco chicquera	Red-necked Falcon
Thalasseus bergii	Great Crested Tern
Pycnonotus leucotis	White-eared Bulbul
Pseudibis papillosa	Red-naped Ibis
Prionochilus/Dicaeum sp.	flowerpecker sp.
Brachypteryx leucophris	Lesser Shortwing
Leptopoecile sophiae	White-browed Tit-Warbler
Columbidae sp.	pigeon/dove sp.
Callacanthis burtoni	Spectacled Finch
Picus chlorolophus/flavinucha	Lesser/Greater Yellownape
Iole indica	Yellow-browed Bulbul
Melanochlora sultanea	Sultan Tit
Tockus sp.	Tockus sp.
Rhipidura albogularis	Spot-breasted Fantail
Trochalopteron virgatum	Striped Laughingthrush
Ardeola sp.	pond-heron sp.
Coracina dobsoni	Andaman Cuckooshrike
Himantopus himantopus	Black-winged Stilt
Charadrius placidus	Long-billed Plover
Aythya sp.	Aythya sp.
Columba leuconota	Snow Pigeon
Nycticorax nycticorax	Black-crowned Night-Heron
Oenanthe isabellina	Isabelline Wheatear
Phoenicurus coeruleocephala	Blue-capped Redstart
Zoothera dauma	Scaly Thrush
Dendrocygna sp.	whistling-duck sp.
Psilopogon sp.	Psilopogon sp.
Riparia sp.	Riparia sp.
Thalasseus sandvicensis	Sandwich Tern
Cinnyris lotenius	Long-billed Sunbird
Oenanthe picata	Variable Wheatear
Apodidae sp. (small swift sp.)	small swift sp.
Enicurus scouleri	Little Forktail
Burhinus indicus	Indian Thick-knee
Iduna rama	Sykes's Warbler
Trochalopteron variegatum	Variegated Laughingthrush
Haliaeetus leucogaster	White-bellied Sea-Eagle
Cissa chinensis	Common Green-Magpie
Zoothera sp.	Zoothera sp.
Haematospiza sipahi	Scarlet Finch
Ianthocincla pectoralis	Greater Necklaced Laughingthrush
Anser albifrons	Greater White-fronted Goose
Monticola sp.	rock-thrush sp.
Psittacula columboides	Malabar Parakeet
Cyanoptila cyanomelana	Blue-and-white Flycatcher
Aerodramus brevirostris	Himalayan Swiftlet
Cercomela fusca	Indian Chat
Mirafra affinis	Jerdon's Bushlark
Calidris alpina	Dunlin
Pycnonotus striatus	Striated Bulbul
Machlolophus aplonotus	Indian Tit
Lophura leucomelanos	Kalij Pheasant
Pericrocotus cantonensis	Brown-rumped Minivet
Muscicapidae sp.	Muscicapid sp.
Falco amurensis	Amur Falcon
Porphyrio/Gallinula/Fulica sp.	gallinule/moorhen/coot sp.
Sarcogyps calvus	Red-headed Vulture
Grus nigricollis	Black-necked Crane
Aethopyga saturata	Black-throated Sunbird
Phylloscopus maculipennis	Ashy-throated Warbler
Dicaeum virescens	Andaman Flowerpecker
Psittacula himalayana	Slaty-headed Parakeet
Streptopelia tranquebarica	Red Collared-Dove
Leucogeranus leucogeranus	Siberian Crane
Rhyticeros narcondami	Narcondam Hornbill
Fulica sp.	coot sp.
Seicercus tephrocephalus	Gray-crowned Warbler
Leucosticte brandti	Black-headed Mountain-Finch
Rallidae sp. (rail/crake sp.)	rail/crake sp.
Caprimulgus atripennis	Jerdon's Nightjar
Charadrius mongolus	Lesser Sand-Plover
Falco cherrug	Saker Falcon
Rallus indicus	Brown-cheeked Rail
Corvus splendens	House Crow
Ketupa ketupu	Buffy Fish-Owl
Monticola saxatilis	Rufous-tailed Rock-Thrush
Oriolus kundoo/chinensis	Indian Golden/Black-naped Oriole
Branta ruficollis	Red-breasted Goose
Numenius sp.	curlew sp.
Perdicula asiatica	Jungle Bush-Quail
Phylloscopus fuscatus	Dusky Warbler
Gallinago sp.	snipe sp.
Pluvialis dominica/fulva	American/Pacific Golden-Plover (Lesser Golden-Plover)
Copsychus malabaricus	White-rumped Shama
Cyornis concretus	White-tailed Flycatcher
Treron phayrei	Ashy-headed Green-Pigeon
Hypsipetes ganeesa	Square-tailed Bulbul
Gygis alba	White Tern
Pelargopsis amauroptera	Brown-winged Kingfisher
Bubulcus ibis	Cattle Egret
Muscicapa sp.	Muscicapa sp.
Ianthocincla rufogularis	Rufous-chinned Laughingthrush
Turnix tanki	Yellow-legged Buttonquail
Hemipus picatus	Bar-winged Flycatcher-shrike
Harpactes fasciatus	Malabar Trogon
Prinia flaviventris	Yellow-bellied Prinia
Garrulax leucolophus	White-crested Laughingthrush
Dicrurus paradiseus	Greater Racket-tailed Drongo
Emberiza cia	Rock Bunting
Tringa nebularia	Common Greenshank
Ardeotis nigriceps	Indian Bustard
Gracupica contra	Asian Pied Starling
Ficedula superciliaris	Ultramarine Flycatcher
Treron chloropterus	Andaman Green-Pigeon
Pyrrhocorax graculus	Yellow-billed Chough
Oriolus xanthornus	Black-hooded Oriole
Dendrocopos nanus/canicapillus	Brown-capped/Gray-capped Woodpecker
Psittacula roseata	Blossom-headed Parakeet
Macropygia rufipennis	Andaman Cuckoo-Dove
Taccocua leschenaultii	Sirkeer Malkoha
Ampeliceps coronatus	Golden-crested Myna
Chloropsis sp.	leafbird sp.
Lanius collurio	Red-backed Shrike
Microcarbo niger/Phalacrocorax fuscicollis	Little/Indian Cormorant
Psittaciformes sp. (parakeet sp.)	parakeet sp.
Chrysocolaptes festivus	White-naped Woodpecker
Glareola maldivarum	Oriental Pratincole
Aythya baeri	Baer's Pochard
Carpospiza brachydactyla	Pale Rockfinch
Garrulax sp.	Garrulax sp.
Carpodacus grandis	Blyth's Rosefinch
Ciconia episcopus	Woolly-necked Stork
Coracina sp.	Coracina sp.
Carpodacus puniceus	Red-fronted Rosefinch
Emberiza rutila	Chestnut Bunting
Pteruthius ripleyi	Himalayan Shrike-Babbler
Ficedula zanthopygia	Korean Flycatcher
Dendrocopos darjellensis	Darjeeling Woodpecker
Pernis apivorus/ptilorhynchus	European/Oriental Honey-buzzard
Gracula religiosa	Common Hill Myna
Saxicola macrorhynchus	White-browed Bushchat
Treron bicinctus	Orange-breasted Pigeon
Sarkidiornis melanotos	Comb Duck
Acridotheres sp.	Acridotheres sp.
Aegypius monachus	Cinereous Vulture
Leptoptilos dubius	Greater Adjutant
Locustella sp.	Locustella sp.
Psilopogon asiaticus	Blue-throated Barbet
Alauda gulgula	Oriental Skylark
Cuculus sp.	Cuculus sp.
Psittacula alexandri	Red-breasted Parakeet
Pnoepyga immaculata	Immaculate Cupwing
Tarsiger hyperythrus	Rufous-breasted Bush-Robin
Todiramphus chloris	Collared Kingfisher
Parus sp.	Parus sp.
Chroicocephalus ridibundus	Black-headed Gull
Calidris sp.	Calidris sp.
Mesophoyx intermedia	Intermediate Egret
Zapornia parva	Little Crake
Stercorarius parasiticus	Parasitic Jaeger
Locustella tacsanowskia	Chinese Bush-Warbler
Ptyonoprogne concolor	Dusky Crag-Martin
Apodidae sp.	swift sp.
Accipiter virgatus	Besra
Phylloscopus neglectus	Plain Leaf Warbler
Rhinoptilus bitorquatus	Jerdon's Courser
Gyps sp.	Gyps sp.
Coracias garrulus	European Roller
Eumyias albicaudatus	Nilgiri Flycatcher
Treron sp.	Treron sp.
Ficedula tricolor	Slaty-blue Flycatcher
Periparus rubidiventris	Rufous-vented Tit
Otus sunia	Oriental Scops-Owl
Monticola rufiventris	Chestnut-bellied Rock-Thrush
Asio flammeus	Short-eared Owl
Pitta megarhyncha	Mangrove Pitta
Vanellus sp.	lapwing sp.
Phylloscopus subviridis	Brooks's Leaf Warbler
Phylloscopus inornatus	Yellow-browed Warbler
Tarsiger indicus	White-browed Bush-Robin
Prunella sp.	accentor sp.
Microcarbo niger	Little Cormorant
Athene blewitti	Forest Owlet
Myzornis pyrrhoura	Fire-tailed Myzornis
Porphyrio sp. (swamphen sp.)	swamphen sp.
Garrulus lanceolatus	Black-headed Jay
Otus balli	Andaman Scops-Owl
Lanius tephronotus	Gray-backed Shrike
Montifringilla blanfordi	Blanford's Snowfinch
Dicaeum sp.	Dicaeum sp.
Collocalia esculenta	Glossy Swiftlet
Cisticola juncidis	Zitting Cisticola
Accipitridae sp. (old world vulture sp.)	old world vulture sp.
Megapomatorhinus erythrogenys	Rusty-cheeked Scimitar-Babbler
Seicercus sp.	Seicercus sp.
Cinclus cinclus	White-throated Dipper
Fringilla coelebs	Common Chaffinch
Cochoa viridis	Green Cochoa
Troglodytes troglodytes	Eurasian Wren
Rhipidura albicollis	White-throated Fantail
Serilophus lunatus	Silver-breasted Broadbill
Sylvia communis	Greater Whitethroat
Carpodacus rubicilla	Great Rosefinch
Syrrhaptes tibetanus	Tibetan Sandgrouse
Saxicola jerdoni	Jerdon's Bushchat
Ianthocincla sannio	White-browed Laughingthrush
Yuhina castaniceps	Striated Yuhina
Fulica atra	Eurasian Coot
Turdoides striata	Jungle Babbler
Minla ignotincta	Red-tailed Minla
Aethopyga vigorsii	Vigors's Sunbird
Amaurornis phoenicurus	White-breasted Waterhen
Dendrocopos sp.	Dendrocopos sp.
Pericrocotus cinnamomeus	Small Minivet
Pycnonotus xantholaemus	Yellow-throated Bulbul
Seicercus whistleri	Whistler's Warbler
Gorsachius melanolophus	Malayan Night-Heron
Vanellus leucurus	White-tailed Lapwing
Spelaeornis caudatus	Rufous-throated Wren-Babbler
Brachypteryx sp.	Brachypteryx sp.
Loriculus vernalis	Vernal Hanging-Parrot
Caprimulgus jotaka	Gray Nightjar
Alcedo atthis	Common Kingfisher
Arborophila rufogularis	Rufous-throated Partridge
Ixobrychus sp.	small bittern sp.
Alcedinidae sp.	kingfisher sp.
Caloenas nicobarica	Nicobar Pigeon
Merops viridis	Blue-throated Bee-eater
Perdicula argoondah	Rock Bush-Quail
Lanius phoenicuroides	Red-tailed Shrike
Stercorarius sp. (jaeger sp.)	jaeger sp.
Perdix hodgsoniae	Tibetan Partridge
Actinodura cyanouroptera	Blue-winged Minla
Sitta leucopsis	White-cheeked Nuthatch
Glaucidium sp.	Glaucidium sp.
Zoothera dixoni	Long-tailed Thrush
Leptocoma zeylonica	Purple-rumped Sunbird
Aethopyga siparaja	Crimson Sunbird
Emberiza godlewskii	Godlewski's Bunting
Tichodroma muraria	Wallcreeper
Otus brucei	Pallid Scops-Owl
Pomatorhinus ochraceiceps	Red-billed Scimitar-Babbler
Coracias sp.	roller sp.
Alcedo hercules	Blyth's Kingfisher
Circus macrourus	Pallid Harrier
Numenius phaeopus	Whimbrel
Francolinus francolinus	Black Francolin
Acridotheres tristis/fuscus	Common/Jungle Myna
Columba rupestris	Hill Pigeon
Psilopogon virens	Great Barbet
Streptopelia chinensis	Spotted Dove
Sitta frontalis	Velvet-fronted Nuthatch
Actinodura waldeni	Streak-throated Barwing
Accipiter soloensis	Chinese Sparrowhawk
Chleuasicus atrosuperciliaris	Pale-billed Parrotbill
Anthus pratensis/trivialis	Meadow/Tree Pipit
Seicercus castaniceps	Chestnut-crowned Warbler
Urocissa flavirostris	Yellow-billed Blue-Magpie
Melanocorypha bimaculata	Bimaculated Lark
Tephrodornis pondicerianus	Common Woodshrike
